++++++++++++++++
+choosewisely+I+
++ +++++++++++G+
+        0+ ++N+
+ +++++++++ ++O+
+           ++R+
+++++++++++ ++E+
+           ++T+
+  +++++++++++H+
+           ++E+
+W+++++++++S++S+
+E+YHOOSCLEI++E+
++++++++++++++++
