+++++++++++
+0      Aa+
+      +A++
+      +a++
+      ++++
+      ++++
+      ++++
+      ++++
+      ++++
+      ++++
+      ++++
+      ++++
+      ++++
+++++++++++
